CDRb	CDRa	Counts
CAISEASGVTYEQYF	CASLGQGAQKLVF	1
CAISEGAAYGYTF	CAVNSDGQKLLF	1
CASGPGTAYGYTF	CAAKDNRKLIW	1
CASGRGPNYGYTF	CAGASTGDYKLSF	1
CASSEALYEQYF	CAGRSYNTNAGKSTF	1
CASSEALYEQYF	CAVTDYKLSF	1
CASSEGPGQGSYEQYF	CAVSDDKIIF	1
CASSFDLAGVNYEQYF	CAVDRDDKIIF	1
CASSFGASYGYTF	CVVNDNDMRF	1
CASSFGDSYEQYF	CVVNMGKNGQKLLF	1
CASSFWGADTQYF	CAWYSGGGADGLTF	1
CASSGGYEQYF	CAEGGGADGLTF	1
CASSHDAGASTGELFF	CASSTDSWGKLQF	1
CASSIQGRGDTEAFF	CAMRSSDPGGYNKLIF	1
CASSLGGQGAYEQYF	CAVTGNQFYF	1
CASSLTALGAAYVYTF	CVVSDDKIIF	1
CASSLTPSASGYEQYF	CVVNNDKIIF	1
CASSPGQVSYEQYF	CAVVGGYNKLIF	1
CASSPGTGGTYEQYF	CVVAEARLMF	1
CASSPMNEQFF	CAVTNDKIIF	1
CASSQAQGTYEQYF	CAVGSDSSYKLIF	1
CASSQGAAYEQYF	CALQDDKIIF	1
CASSQGGGTEAFF	CAVNEGTGNQFYF	1
CASSQTAGGYEQYF	CAVIGSGKLIF	1
CASSVDGGSQPQHF	CVVADDKIIF	1
CASSVGGVPYNEQFF	CARNTGNQFYF	1
CASSYGGGYEQYF	CIVAAISGSARQLTF	1
CATSPRGGHEQYF	CAGNNARLMF	1
CATSRTGTGSTEAFF	CAVSDDKIIF	1
CATSSSGAYEQYF	CAPGDDKIIF	1
CSAIGPRGTDTQYF	CAFEGGKLIF	1
CSAWWGAEQYF	CAVRLGGADGLTF	1
